XXXXXXXXXXXXXXXXXXXXXXXXXXXXXXXXXXXXXXXXXXXXXXXXXX00000000000000000000000000000000000000000000000000000000000000000000000000000000000000000000000000000000000000000000000000000000000000000000
XXXXXXXXXXXXXXXXXXXXXXXXXXXXXXXXXXXXXXXXXXXXXXXXX000000000000000000000000000000000000000000000000000000000000000000000000000000000000000000000000000000000000000000000000000000000000000000000
XXXXXXXXXXXXXXXXXXXXXXXXXXXXXXXXXXXXXXXXXXXXXX000000000000000000000000000000000000000000000000000000000000000000000000000000000000000000000000000000000000000000000000000000000000000000000000
XXXXXXXXXXXXXXXXXXX.0000000000XXXXXXXXXXXXX000000000000000000000000000000000000000000000000000000000000000000000000000000000000000000000000000000000000000000000000000000000000000000000000000
XXXXXXXXXXXXXXX*.**..*XXXXXX000000000000000000000000000000000000000000000000000000000000000000000000000000000000000000000000000000000000000000000000000000000000000000000000000XXX000000000000
XXXXXXXXXXXXXXXX***.*XXXXXXXXXXXXXXXXXXX00000000000000000000000000000000000000000000000000000000000000000000000000000000000000000000000000000000000000000000000000000000000000XXX0000000000000
XXXXXXXXXXXXXXXXXXXXXXXXXXXXXXXXXXXXXX00000000000000000000000000000000000000000000000000000...*........00000000000000000000000000000000000000000000000000000000000000000000XXXX000000000000000
XXXXXXXXXXXXXXXXXXXXXXXXXXXXXXXXXXXXXXXXXXX00000000000000000000000000000000000000000000000000000000*........*.00000000000000000000000000000000000000000000000000000XXXXXXXXXX00000000000000000
XXXXXXXXXXXXXXXXXXXXXXXXXXXXXXXXXXXXXXXXXXX00000000000000000000000000000000000000000..*.......0000000000000000000000000000000000000000000000000000000000000000000000000XXXXXXXXXX0000000000000
XXXXXXXXXXXXXXXXXXXXXXXXXXXXXXXXXXXXXXXXXXXXX00000000000XXXX0000000000000000000000000.....*......00000....*......*..000000000000000000000000000000000000000000000000000000XXXX0000000000000000
XXXXXXXXXXXXXXXXXXXXXXXXXXX0000000000000000000000000000000XX00000000000000000000000000000.....00000000000..*.....00000000000000000000000000000000000000000000000000000000000000000000000000000
XXXXXXXXXXXXXXXXXXXXXX00000000000000000000000000000000000000000000000000000000000000000000..*0000000000000000000000000000000000000000000000000000000000000000000000000000000000000000000000000
XXXXXXXXXXXX0000000000000000000000000000000000000000000000000000000000000000000000000000000000000000000000000000000000000000000000000000000000000000000000000000000000000000000000000000000000
XXXXXX00000000000000000000000000000000000000000000000000000000000000000000000000000000000000....*.......**...000000000000000000000000000000000000000000000000000000000000000000000000000000000
XXX0000000000000000000000000000000000000000000000000000000000000000000000000000000000000000000000000000000000000000000000000000000000000000000000000000000000000000000000000000000000000000000
0000000000000000000000000000000000000000000000000000000000000000000000000000000000000000000000000000000000000000000000000000000000000000000000000000000000000000000000000000000000000000000000
000000000000000000000000000000000000000000000000000000000000000000000000000000000000000000000000000000000000000000000000000000000000000XXX0000000000000000000000000000000000000000000000000000
000000000000000000000000000000000000000000000000000000000000000000000000000000000000000000000000000000000000000000000000000000000000000XXXXX00000000000000000000000000000000000000000000000000
0000000000000000000000000000000000000000000000000000000000000000000000000000000000000000000~~~~~~~000000000000000000000000000000000000XXXXXXX0000000000000000000000000000000000000000000000000
0000000000000000000000000000000000000000000000000000000000000000000000000000000000000000~~~~~~~~~~~~~00000000000000000000000000000000XXXXXXXX0000000000000000000000000000000000000000000000000
0000000000000000000000000000000000000000000000000000000000000000000000000000000~~~~~~~~~~~~~~~~~~~~~~~~0000000000000000000000000XXXXXXXXXXXXXX000000000000000000000000000000000000000000000000
0000000000000000000000000000........*.........000000000000000000000000000000~~~~~~~~~~~~~~~~~~~~~~~~~~0000000000000000000000000000XXXXXXXXX000000000000000000000000000000000000000000000000000
00000000000000000000......00000000000....000000000000000000000000000000000~~~~~~~~~~~~~~~~~~~~~~~~~~~~~~~~~~~~0000000000000000000XXXXXXXXXXXXXX00000000000000000000000000000000000000000000000
000000000000000000000000000000...0000......00000000000000000000000~~~~~~~~~~~~~~~~~~~~~~~~~~~~~~~~~~~~~~~~~~~~~00000000000000000000XXXXXXXXXXX000000000000000000000000000000000000000000000000
00000000000000000000000.......*.............000000000000000000000~~~~~~~~~~~~~~~~~~~~~~~~~~~~~~~~~~~~~~~~~~~0000000000000000000000XXXXXXXXX000000000000000000000000000000000000000000000000000
00000000000000000000.............*.....00000000000000000000000000~~~~~~~~~~~~~~~~~~~~~~~~~~~~~~~~~~~~~~000000000000000000000000000000XXXXXXXX0000000000000000000000000000000000000000000000000
000000000000000000000000000000000000000000000000000000000000000000~~~~~~~~~~~~~~~~~~~~~~~~~~~~~~~~00000000000000000000000000000000000000000000000000000000000000000000000000000000000000000000
000000000000000000000000000000000000000000000000000000000000000000~~~~~~~~~~~~~~~~~~~~~~~~~~~~~00000000000000000000000000000000000000000000000000000000000000000000000000000000000000000000000
00000000000000000000000000.........*.........00000000000000000000000000~~~~~~~~~~~~~~~~~~~~~~~~~~~00000000000000000000000000000000000000000000000000000000000000000000000000000000000000000000
000000000000000000000000000000000000000000000000000000000000000000000000000000~~~~~~~~~~~~~~~~~~0000000000000000000000000000000000000000000000000000000000000000000000000000000000000000000000
0000000000000000000000000000000000000000000000000000000000000000000000000000000000~~~~~~~~~~~~~00000000000000000000000000000000000000000000000000000000000000000000000000000000000000000000000
0000000000000000000000000000000000000000000000000000000000000000000000000000000000000~~~~~~~~000000000000000000000000000000000...*..................000000000000000000000000000000000000000000
000000000000000000000000000000000000000000000000000000000000000000000000000000000000000000000000000000000000000000000000000.............000000...00000..00000000000000000000000000000000000000
00000000000000000000000000000000000000000000000000000000000000000000000000000000000000000000000000000000000000000000000000000000.............**...........000000000000000000000000000000000000
0000000000000000000000000000000000000000000000000000000000000000000000000000000000000000000000000000000000000000000000000000000000......*.........*.*....0000000000000000000000000000000000000
00000000000000000000000000000000000000000000000000000000000000000000000000000000000000000000000000000000000000000000000000000000000000.....*............00000000000000000000000000000000000000
0000000000000000000000000000000000000000X0000000000000000000000000000000000000000000000000000000000000000000000000000000000000000000000000000.......000000000000000000000000000000000000000000
000000000000000000000000000000000000000XXX0000000000000000000000000000000000000000000000000000000000000000000000000000000000000000000000000000.00000000000000000000000000000000000000000000000
000000000000000000000000000000000000000000000000000000000000000000000000000000.........*.......*.....*..*..000000000000000000000000000000000000..*.0000000000000000000000000000000000000000000
000000000000000000000000000000000000000000000000000000000000000000000000000000000....*..0000..........0000000000000000000000000000000000000000000...0.0000000000000000000000000000000000000000
00000000000000000000000000000000000000000000000000000000000000000000000000000000000000*....*........000000000000000000000000000000000000000000000000000000000000000000000000000000000000000000
000000000000000000000000000000000000~~~~0000000000000000000000000000000000000000000000000000000*.000000000000000000000000000000000000000000000000000000000000000000000000000000000000000000000
000000000000000000000000000000~~~~~~~~~~~~~00000000000000000000000000000000000000000000.....*......*..0000000000000000000000000000000000000000000000000000000000000000000000000000000000000000
00000000000000000000000000000000000~~~~~~~~~~~0000000000000000000000000000000000000000000000000.......*..0000000000000000000000000000000000000000000000X00000000000000000000000000000000000000
0000000000000000000000000000000000~~~~~~~~~~000000000000000000000000000000000000000000000000000000000......*.*...000000000000000000000000000000000000XXXX0000000000000000000000000000000000000
0000000000000000000000000000000000000~~~~000000000000000000000000000000000000000000000000000000000000000000000000000000000000000000000000000000000XXXXXXX0000000000000000000000000000000000000
0000000000000000000000000000000000000000000000000000000000000000000000000000000000000000000000000000000000000000000000000000000000000000000000000000XXX000000000000000000000000000000000000000
0000000000000000000000000000000000000000000000000000000000000000000000000000000000000000000000000000000000000000000000000000000000000000000000000000000000000000000000000000000000000000000000
0000000000000000000000000000000000000000000000000000000000000000000000000000000000000000000000000000000000000000000000000000000000000000000000000000000000000000000000000000000000000000000000
0000000000000000000000000000000000000000000000000000000000000000000000000000000000000000000000000000000000000000000000000000000000000000000000000000000000000000000000000000000000000000000000